1111111111111111111111111111111111
101000000001000C00000C000000000001
10100101000000001010010000C0010101
101001001011111000100100000C010101
1P0001000B000100010000111100000001
100001000000C10001000000C000000001
100001000C00000C00000C0000C0000001
1000010000000000010000000000000001
100C0100001011000100001000C0000001
10000101001C0100010000100101110001
100000010000010001010010010E000001
1111111111111111111111111111111111
